able bodied	 ablebodied
able-bodied	 ablebodied
absent minded	 absentminded
absent mindedly	 absentmindedly
absent mindedness	 absentmindedness
absent-minded	 absentminded
absent-mindedly	 absentmindedly
absent-mindedness	 absentmindedness
after dinner	 afterdinner
after-dinner	 afterdinner
air conditioned	 airconditioned
air force	 airforce
air-conditioned	 airconditioned
alarm clock	 alarmclock
all powerful	 allpowerful
all right	 allright
all-powerful	 allpowerful
arm chair	 armchair
arm-chair	 armchair
avant garde	 avantgarde
avant-garde	 avantgarde
awe inspiring	 aweinspiring
awe-inspiring	 aweinspiring
bad luck	 badluck
bad tempered	 badtempered
bad-tempered	 badtempered
bald headed	 baldheaded
bald-headed	 baldheaded
barbed wire	 barbedwire
barbed-wire	 barbedwire
bare chested	 barechested
bare-chested	 barechested
bathing suit	 bathingsuit
battle weary	 battleweary
battle-weary	 battleweary
bedside table	 bedsidetable
best looking	 bestlooking
best-looking	 bestlooking
big time	 bigtime
big-time	 bigtime
black market	 blackmarket
black-market	 blackmarket
blood red	 bloodred
blood soaked	 bloodsoaked
blood-red	 bloodred
blood-soaked	 bloodsoaked
bloody minded	 bloodyminded
bloody-minded	 bloodyminded
boarding house	 boardinghouse
boarding school	 boardingschool
boarding-house	 boardinghouse
boarding-school	 boardingschool
brand new	 brandnew
brand-new	 brandnew
breast pocket	 breastpocket
bright red	 brightred
bright-red	 brightred
broad shouldered	 broadshouldered
broad-shouldered	 broadshouldered
broken down	 brokendown
broken hearted	 brokenhearted
broken-down	 brokendown
broken-hearted	 brokenhearted
brother in law	 brotherinlaw
brother-in-law	 brotherinlaw
buenos aires	 buenosaires
bull headed	 bullheaded
bull-headed	 bullheaded
burned out	 burnedout
burned-out	 burnedout
burnt out	 burntout
burnt-out	 burntout
cardboard box	 cardboardbox
cast iron	 castiron
cast-iron	 castiron
cell phone	 cellphone
central park	 centralpark
chief inspector	 chiefinspector
child like	 childlike
child-like	 childlike
chimney piece	 chimneypiece
chimney-piece	 chimneypiece
christmas eve	 christmaseve
civil war	 civilwar
clear cut	 clearcut
clear headed	 clearheaded
clear-cut	 clearcut
clear-headed	 clearheaded
close cropped	 closecropped
close fitting	 closefitting
close up	 closeup
close-cropped	 closecropped
close-fitting	 closefitting
close-up	 closeup
closed minded	 closedminded
closed-minded	 closedminded
coal black	 coalblack
coal-black	 coalblack
coca cola	 cocacola
coca-cola	 cocacola
cold blooded	 coldblooded
cold hearted	 coldhearted
cold heartedness	 coldheartedness
cold-blooded	 coldblooded
cold-hearted	 coldhearted
cold-heartedness	 coldheartedness
come on	 comeon
commander in chief	 commanderinchief
commander-in-chief	 commanderinchief
commanding officer	 commandingofficer
common sense	 commonsense
communist party	 communistparty
court martial	 courtmartial
court-martial	 courtmartial
cream coloured	 creamcoloured
cream-coloured	 creamcoloured
criss crossed	 crisscrossed
criss-crossed	 crisscrossed
cross country	 crosscountry
cross examination	 crossexamination
cross eyed	 crosseyed
cross legged	 crosslegged
cross-country	 crosscountry
cross-examination	 crossexamination
cross-eyed	 crosseyed
cross-legged	 crosslegged
cul de sac	 culdesac
cul-de-sac	 culdesac
cultural revolution	 culturalrevolution
dark blue	 darkblue
dark brown	 darkbrown
dark green	 darkgreen
dark red	 darkred
dark-blue	 darkblue
dark-brown	 darkbrown
dark-green	 darkgreen
dark-red	 darkred
daughter in law	 daughterinlaw
daughter-in-law	 daughterinlaw
dead end	 deadend
dead-end	 deadend
deep rooted	 deeprooted
deep sea	 deepsea
deep seated	 deepseated
deep set	 deepset
deep-rooted	 deeprooted
deep-sea	 deepsea
deep-seated	 deepseated
deep-set	 deepset
department store	 departmentstore
deputy commander	 deputycommander
devil may care	 devilmaycare
devil-may-care	 devilmaycare
dining room	 diningroom
dining-room	 diningroom
dinner party	 dinnerparty
dinner table	 dinnertable
dinner-party	 dinnerparty
dinner-table	 dinnertable
district attorney	 districtattorney
district captain	 districtcaptain
double breasted	 doublebreasted
double-breasted	 doublebreasted
down stairs	 downstairs
down-stairs	 downstairs
drawing room	 drawingroom
drawing rooms	 drawingrooms
drawing-room	 drawingroom
drawing-rooms	 drawingrooms
dressing gown	 dressinggown
dressing table	 dressingtable
dressing-gown	 dressinggown
dressing-table	 dressingtable
dried out	 driedout
dried-out	 driedout
drive in	 drivein
drive-in	 drivein
e mail	 email
e mails	 emails
e-mail	 email
e-mails	 emails
easy chair	 easychair
easy going	 easygoing
easy-chair	 easychair
easy-going	 easygoing
editor in chief	 editorinchief
editor-in-chief	 editorinchief
elementary school	 elementaryschool
empty handed	 emptyhanded
empty-handed	 emptyhanded
entrance hall	 entrancehall
even tempered	 eventempered
even-tempered	 eventempered
ever changing	 everchanging
ever-changing	 everchanging
ex husband	 exhusband
ex wife	 exwife
ex-husband	 exhusband
ex-wife	 exwife
excuse me	 excuseme
eye catcher	 eyecatcher
eye catching	 eyecatching
eye-catcher	 eyecatcher
eye-catching	 eyecatching
face to face	 facetoface
face-to-face	 facetoface
fair skinned	 fairskinned
fair-skinned	 fairskinned
fairy tale	 fairytale
fairy-tale	 fairytale
far away	 faraway
far fetched	 farfetched
far flung	 farflung
far reaching	 farreaching
far-away	 faraway
far-fetched	 farfetched
far-flung	 farflung
far-reaching	 farreaching
fast food	 fastfood
fast-food	 fastfood
father in law	 fatherinlaw
father-in-law	 fatherinlaw
fifth avenue	 fifthavenue
fine looking	 finelooking
fine-looking	 finelooking
first aid	 firstaid
first born	 firstborn
first class	 firstclass
first-aid	 firstaid
first-born	 firstborn
first-class	 firstclass
flip flops	 flipflops
flip-flops	 flipflops
fortune teller	 fortuneteller
fortune-teller	 fortuneteller
foul smelling	 foulsmelling
foul-smelling	 foulsmelling
fountain pen	 fountainpen
free swinging	 freeswinging
free-swinging	 freeswinging
frock coat	 frockcoat
frock-coat	 frockcoat
front door	 frontdoor
front page	 frontpage
front-door	 frontdoor
front-page	 frontpage
fucked up	 fuckedup
fucked-up	 fuckedup
full blown	 fullblown
full fledged	 fullfledged
full grown	 fullgrown
full length	 fulllength
full page	 fullpage
full time	 fulltime
full-blown	 fullblown
full-fledged	 fullfledged
full-grown	 fullgrown
full-length	 fulllength
full-page	 fullpage
full-time	 fulltime
fur coat	 furcoat
gas station	 gasstation
god damned	 goddamned
god fearing	 godfearing
god given	 godgiven
god-damned	 goddamned
god-fearing	 godfearing
god-given	 godgiven
godâ€™s sake	 godssake
good afternoon	 goodafternoon
good by	 goodby
good bye	 goodbye
good evening	 goodevening
good hearted	 goodhearted
good humored	 goodhumored
good humoured	 goodhumoured
good looking	 goodlooking
good luck	 goodluck
good morning	 goodmorning
good nature	 goodnature
good natured	 goodnatured
good naturedly	 goodnaturedly
good natures	 goodnatures
good night	 goodnight
good sized	 goodsized
good will	 goodwill
good-by	 goodby
good-bye	 goodbye
good-hearted	 goodhearted
good-humored	 goodhumored
good-humoured	 goodhumoured
good-looking	 goodlooking
good-nature	 goodnature
good-natured	 goodnatured
good-naturedly	 goodnaturedly
good-natures	 goodnatures
good-sized	 goodsized
good-will	 goodwill
governor general	 governorgeneral
governor-general	 governorgeneral
great aunt	 greataunt
great grandfather	 greatgrandfather
great grandmother	 greatgrandmother
great uncle	 greatuncle
great-aunt	 greataunt
great-grandfather	 greatgrandfather
great-grandmother	 greatgrandmother
great-uncle	 greatuncle
grief stricken	 griefstricken
grief-stricken	 griefstricken
grocery store	 grocerystore
guilt free	 guiltfree
guilt ridden	 guiltridden
guilt stricken	 guiltstricken
guilt-free	 guiltfree
guilt-ridden	 guiltridden
guilt-stricken	 guiltstricken
hair raising	 hairraising
hair-raising	 hairraising
half asleep	 halfasleep
half baked	 halfbaked
half breed	 halfbreed
half dead	 halfdead
half eaten	 halfeaten
half finished	 halffinished
half forgotten	 halfforgotten
half full	 halffull
half hearted	 halfhearted
half hidden	 halfhidden
half light	 halflight
half moon	 halfmoon
half naked	 halfnaked
half opened	 halfopened
half smile	 halfsmile
half starved	 halfstarved
half turned	 halfturned
half witted	 halfwitted
half-asleep	 halfasleep
half-baked	 halfbaked
half-breed	 halfbreed
half-dead	 halfdead
half-eaten	 halfeaten
half-finished	 halffinished
half-forgotten	 halfforgotten
half-full	 halffull
half-hearted	 halfhearted
half-hidden	 halfhidden
half-light	 halflight
half-moon	 halfmoon
half-naked	 halfnaked
half-opened	 halfopened
half-smile	 halfsmile
half-starved	 halfstarved
half-turned	 halfturned
half-witted	 halfwitted
hand painted	 handpainted
hand-painted	 handpainted
happy go lucky	 happygolucky
happy-go-lucky	 happygolucky
hard boiled	 hardboiled
hard headed	 hardheaded
hard hearted	 hardhearted
hard nosed	 hardnosed
hard pressed	 hardpressed
hard won	 hardwon
hard working	 hardworking
hard-boiled	 hardboiled
hard-headed	 hardheaded
hard-hearted	 hardhearted
hard-nosed	 hardnosed
hard-pressed	 hardpressed
hard-won	 hardwon
hard-working	 hardworking
heart attack	 heartattack
heart rending	 heartrending
heart shaped	 heartshaped
heart warmed	 heartwarmed
heart warming	 heartwarming
heart-rending	 heartrending
heart-shaped	 heartshaped
heart-warmed	 heartwarmed
heart-warming	 heartwarming
heavy hearted	 heavyhearted
heavy lidded	 heavylidded
heavy-hearted	 heavyhearted
heavy-lidded	 heavylidded
hi fi	 hifi
hi-fi	 hifi
hide and seek	 hideandseek
hide-and-seek	 hideandseek
hiding place	 hidingplace
hiding-place	 hidingplace
high class	 highclass
high heeled	 highheeled
high heels	 highheels
high level	 highlevel
high minded	 highminded
high pitched	 highpitched
high quality	 highquality
high ranking	 highranking
high rise	 highrise
high school	 highschool
high spirited	 highspirited
high strung	 highstrung
high tech	 hightech
high-class	 highclass
high-heeled	 highheeled
high-level	 highlevel
high-minded	 highminded
high-pitched	 highpitched
high-quality	 highquality
high-ranking	 highranking
high-rise	 highrise
high-school	 highschool
high-spirited	 highspirited
high-strung	 highstrung
high-tech	 hightech
home made	 homemade
home-made	 homemade
honey colored	 honeycolored
honey-colored	 honeycolored
hong kong	 hongkong
horror stricken	 horrorstricken
horror-stricken	 horrorstricken
hot headed	 hotheaded
hot headedness	 hotheadedness
hot tempered	 hottempered
hot-headed	 hotheaded
hot-headedness	 hotheadedness
hot-tempered	 hottempered
human being	 humanbeing
human beings	 humanbeings
ice cold	 icecold
ice cream	 icecream
ice-cold	 icecold
ice-cream	 icecream
ill advised	 illadvised
ill concealed	 illconcealed
ill fated	 illfated
ill fitting	 illfitting
ill humored	 illhumored
ill mannered	 illmannered
ill natured	 illnatured
ill tempered	 illtempered
ill used	 illused
ill will	 illwill
ill-advised	 illadvised
ill-concealed	 illconcealed
ill-fated	 illfated
ill-fitting	 illfitting
ill-humored	 illhumored
ill-mannered	 illmannered
ill-natured	 illnatured
ill-tempered	 illtempered
ill-used	 illused
ill-will	 illwill
iron willed	 ironwilled
iron-willed	 ironwilled
jesus christ	 jesuschrist
jet black	 jetblack
jet-black	 jetblack
kind hearted	 kindhearted
kind-hearted	 kindhearted
laid back	 laidback
laid-back	 laidback
large scale	 largescale
large-scale	 largescale
last minute	 lastminute
last-minute	 lastminute
late afternoon	 lateafternoon
late-afternoon	 lateafternoon
law abiding	 lawabiding
law-abiding	 lawabiding
leather bound	 leatherbound
leather jacket	 leatherjacket
leather-bound	 leatherbound
left hand	 lefthand
left-hand	 lefthand
level headed	 levelheaded
level headedness	 levelheadedness
level-headed	 levelheaded
level-headedness	 levelheadedness
life long	 lifelong
life size	 lifesize
life-long	 lifelong
life-size	 lifesize
light blue	 lightblue
light brown	 lightbrown
light colored	 lightcolored
light coloured	 lightcoloured
light headed	 lightheaded
light headedness	 lightheadedness
light hearted	 lighthearted
light heartedness	 lightheartedness
light skinned	 lightskinned
light years	 lightyears
light-blue	 lightblue
light-brown	 lightbrown
light-colored	 lightcolored
light-coloured	 lightcoloured
light-headed	 lightheaded
light-headedness	 lightheadedness
light-hearted	 lighthearted
light-heartedness	 lightheartedness
light-skinned	 lightskinned
light-years	 lightyears
living room	 livingroom
living-room	 livingroom
long awaited	 longawaited
long dead	 longdead
long drawn	 longdrawn
long suffering	 longsuffering
long term	 longterm
long winded	 longwinded
long-awaited	 longawaited
long-dead	 longdead
long-drawn	 longdrawn
long-suffering	 longsuffering
long-term	 longterm
long-winded	 longwinded
looking glass	 lookingglass
looking-glass	 lookingglass
loose fitting	 loosefitting
loose-fitting	 loosefitting
los angeles	 losangeles
love making	 lovemaking
love-making	 lovemaking
low cut	 lowcut
low level	 lowlevel
low lying	 lowlying
low spirited	 lowspirited
low spiritedness	 lowspiritedness
low-cut	 lowcut
low-level	 lowlevel
low-lying	 lowlying
low-spirited	 lowspirited
low-spiritedness	 lowspiritedness
machine gun	 machinegun
machine-gun	 machinegun
mail order	 mailorder
mail-order	 mailorder
main street	 mainstreet
make believe	 makebelieve
make up	 makeup
make-believe	 makebelieve
make-up	 makeup
man made	 manmade
man-made	 manmade
market place	 marketplace
market-place	 marketplace
martial arts	 martialarts
martin luther	 martinluther
merry go round	 merrygoround
merry-go-round	 merrygoround
mexico city	 mexicocity
mid afternoon	 midafternoon
mid air	 midair
mid day	 midday
mid-afternoon	 midafternoon
mid-air	 midair
mid-day	 midday
middle aged	 middleaged
middle class	 middleclass
middle-aged	 middleaged
middle-class	 middleclass
milk white	 milkwhite
milk-white	 milkwhite
mind blowing	 mindblowing
mind blown	 mindblown
mind-blowing	 mindblowing
mind-blown	 mindblown
mobile phone	 mobilephone
monte cristo	 montecristo
mother in law	 motherinlaw
mother of pearl	 motherofpearl
mother-in-law	 motherinlaw
mother-of-pearl	 motherofpearl
narrow minded	 narrowminded
narrow mindedness	 narrowmindedness
narrow-minded	 narrowminded
narrow-mindedness	 narrowmindedness
navy blue	 navyblue
navy-blue	 navyblue
near by	 nearby
near-by	 nearby
never ending	 neverending
never mind	 nevermind
never-ending	 neverending
new born	 newborn
new england	 newengland
new hampshire	 newhampshire
new jersey	 newjersey
new orleans	 neworleans
new year	 newyear
new york	 newyork
new zealand	 newzealand
new-born	 newborn
next door	 nextdoor
next-door	 nextdoor
nice looking	 nicelooking
nice-looking	 nicelooking
night time	 nighttime
night-time	 nighttime
nit picky	 nitpicky
nit-picky	 nitpicky
no one	 noone
no-one	 noone
non existent	 nonexistent
non stop	 nonstop
non-existent	 nonexistent
non-stop	 nonstop
odd looking	 oddlooking
odd-looking	 oddlooking
of course	 ofcourse
oil lamp	 oillamp
old fashioned	 oldfashioned
old style	 oldstyle
old-fashioned	 oldfashioned
old-style	 oldstyle
olive green	 olivegreen
olive oil	 oliveoil
olive-green	 olivegreen
one armed	 onearmed
one eyed	 oneeyed
one way	 oneway
one-armed	 onearmed
one-eyed	 oneeyed
one-way	 oneway
open air	 openair
open hearted	 openhearted
open minded	 openminded
open mindedness	 openmindedness
open mouthed	 openmouthed
open-air	 openair
open-hearted	 openhearted
open-minded	 openminded
open-mindedness	 openmindedness
open-mouthed	 openmouthed
orange juice	 orangejuice
out of date	 outofdate
out-of-date	 outofdate
over educated	 overeducated
over protected	 overprotected
over protection	 overprotection
over-educated	 overeducated
over-protected	 overprotected
over-protection	 overprotection
pale blue	 paleblue
pale faced	 palefaced
pale-blue	 paleblue
pale-faced	 palefaced
palm trees	 palmtrees
panic stricken	 panicstricken
panic-stricken	 panicstricken
parking lot	 parkinglot
part time	 parttime
part-time	 parttime
passenger seat	 passengerseat
passive aggression	 passiveaggression
passive aggressive	 passiveaggressive
passive-aggression	 passiveaggression
passive-aggressive	 passiveaggressive
peace loving	 peaceloving
peace-loving	 peaceloving
peach blossom	 peachblossom
pell mell	 pellmell
pell-mell	 pellmell
phone call	 phonecall
phone calls	 phonecalls
pig headed	 pigheaded
pig-headed	 pigheaded
pince nez	 pincenez
pince-nez	 pincenez
pine trees	 pinetrees
ping pong	 pingpong
ping-pong	 pingpong
pitch black	 pitchblack
pitch-black	 pitchblack
plain clothes	 plainclothes
plain-clothes	 plainclothes
pocket book	 pocketbook
pocket-book	 pocketbook
point blank	 pointblank
point-blank	 pointblank
police station	 policestation
polka dot	 polkadot
polka-dot	 polkadot
post office	 postoffice
post war	 postwar
post-office	 postoffice
post-war	 postwar
prime minister	 primeminister
quick witted	 quickwitted
quick wittedness	 quickwittedness
quick-witted	 quickwitted
quick-wittedness	 quickwittedness
railway station	 railwaystation
rain soaked	 rainsoaked
rain-soaked	 rainsoaked
razor sharp	 razorsharp
razor-sharp	 razorsharp
re energized	 reenergized
re-energized	 reenergized
ready made	 readymade
ready-made	 readymade
real estate	 realestate
real life	 reallife
real-life	 reallife
rearview mirror	 rearviewmirror
red army	 redarmy
red brick	 redbrick
red cross	 redcross
red faced	 redfaced
red hot	 redhot
red-brick	 redbrick
red-faced	 redfaced
red-hot	 redhot
reddish brown	 reddishbrown
reddish-brown	 reddishbrown
right hand	 righthand
right-hand	 righthand
rock ribbed	 rockribbed
rock-ribbed	 rockribbed
rocking chair	 rockingchair
rolls royce	 rollsroyce
rolls-royce	 rollsroyce
rose colored	 rosecolored
rose coloured	 rosecoloured
rose-colored	 rosecolored
rose-coloured	 rosecoloured
rosy cheeked	 rosycheeked
rosy-cheeked	 rosycheeked
rough hewn	 roughhewn
rough-hewn	 roughhewn
salt lake city	 saltlakecity
san francisco	 sanfrancisco
santa teresa	 santateresa
second class	 secondclass
second hand	 secondhand
second-class	 secondclass
second-hand	 secondhand
secretary general	 secretarygeneral
secretary-general	 secretarygeneral
security guard	 securityguard
see through	 seethrough
see-through	 seethrough
self abased	 selfabased
self abasement	 selfabasement
self abasing	 selfabasing
self abnegating	 selfabnegating
self abnegation	 selfabnegation
self absorbed	 selfabsorbed
self absorption	 selfabsorption
self accusation	 selfaccusation
self aggrandizement	 selfaggrandizement
self aggrandizing	 selfaggrandizing
self appointed	 selfappointed
self asserting	 selfasserting
self assertion	 selfassertion
self assertive	 selfassertive
self assertiveness	 selfassertiveness
self assurance	 selfassurance
self assured	 selfassured
self assuring	 selfassuring
self aware	 selfaware
self awareness	 selfawareness
self balancing	 selfbalancing
self blame	 selfblame
self care	 selfcare
self centered	 selfcentered
self centeredness	 selfcenteredness
self collected	 selfcollected
self command	 selfcommand
self complacency	 selfcomplacency
self complacent	 selfcomplacent
self composed	 selfcomposed
self composure	 selfcomposure
self conceit	 selfconceit
self conceited	 selfconceited
self concern	 selfconcern
self condemnation	 selfcondemnation
self condemned	 selfcondemned
self confessed	 selfconfessed
self confidence	 selfconfidence
self confident	 selfconfident
self congratulating	 selfcongratulating
self congratulation	 selfcongratulation
self congratulatory	 selfcongratulatory
self conscious	 selfconscious
self consciously	 selfconsciously
self consciousness	 selfconsciousness
self consistent	 selfconsistent
self contained	 selfcontained
self contemplation	 selfcontemplation
self control	 selfcontrol
self controlled	 selfcontrolled
self controlling	 selfcontrolling
self critical	 selfcritical
self criticism	 selfcriticism
self cultivation	 selfcultivation
self deceit	 selfdeceit
self deceived	 selfdeceived
self deceiving	 selfdeceiving
self deception	 selfdeception
self defeating	 selfdefeating
self defence	 selfdefence
self defense	 selfdefense
self denial	 selfdenial
self denied	 selfdenied
self denier	 selfdenier
self deniying	 selfdeniying
self deprecating	 selfdeprecating
self deprecation	 selfdeprecation
self deprecatory	 selfdeprecatory
self destruction	 selfdestruction
self destructive	 selfdestructive
self determination	 selfdetermination
self determined	 selfdetermined
self determining	 selfdetermining
self discipline	 selfdiscipline
self disciplined	 selfdisciplined
self discovery	 selfdiscovery
self disgust	 selfdisgust
self disgusted	 selfdisgusted
self distrust	 selfdistrust
self doubt	 selfdoubt
self doubting	 selfdoubting
self educated	 selfeducated
self education	 selfeducation
self effaced	 selfeffaced
self effacement	 selfeffacement
self effacing	 selfeffacing
self esteem	 selfesteem
self evident	 selfevident
self examination	 selfexamination
self examining	 selfexamining
self expression	 selfexpression
self flagellated	 selfflagellated
self flagellating	 selfflagellating
self flagellation	 selfflagellation
self forgetful	 selfforgetful
self forgetfulness	 selfforgetfulness
self forgetting	 selfforgetting
self fulfillment	 selffulfillment
self gratification	 selfgratification
self hate	 selfhate
self hating	 selfhating
self hatred	 selfhatred
self help	 selfhelp
self importance	 selfimportance
self important	 selfimportant
self imposed	 selfimposed
self improvement	 selfimprovement
self indulged	 selfindulged
self indulgence	 selfindulgence
self indulgent	 selfindulgent
self indulging	 selfindulging
self interest	 selfinterest
self interested	 selfinterested
self involved	 selfinvolved
self involvement	 selfinvolvement
self justification	 selfjustification
self justified	 selfjustified
self justifying	 selfjustifying
self knowledge	 selfknowledge
self loathing	 selfloathing
self love	 selflove
self loving	 selfloving
self made	 selfmade
self mortification	 selfmortification
self motivated	 selfmotivated
self motivation	 selfmotivation
self neglect	 selfneglect
self obsessed	 selfobsessed
self obsession	 selfobsession
self opinion	 selfopinion
self opinionated	 selfopinionated
self pity	 selfpity
self pitying	 selfpitying
self possessed	 selfpossessed
self possession	 selfpossession
self praise	 selfpraise
self preservation	 selfpreservation
self preserving	 selfpreserving
self pride	 selfpride
self protection	 selfprotection
self punishment	 selfpunishment
self realization	 selfrealization
self reliance	 selfreliance
self reliant	 selfreliant
self relying	 selfrelying
self renewal	 selfrenewal
self renewing	 selfrenewing
self reproach	 selfreproach
self reproached	 selfreproached
self reproachful	 selfreproachful
self reproaching	 selfreproaching
self respect	 selfrespect
self respectful	 selfrespectful
self respecting	 selfrespecting
self restrained	 selfrestrained
self restraining	 selfrestraining
self restraint	 selfrestraint
self righteous	 selfrighteous
self righteousness	 selfrighteousness
self sacrifice	 selfsacrifice
self sacrificing	 selfsacrificing
self satisfaction	 selfsatisfaction
self satisfied	 selfsatisfied
self satisfying	 selfsatisfying
self seeking	 selfseeking
self sufficiency	 selfsufficiency
self sufficient	 selfsufficient
self torment	 selftorment
self tormented	 selftormented
self torture	 selftorture
self tortured	 selftortured
self will	 selfwill
self willed	 selfwilled
self worship	 selfworship
self worth	 selfworth
self-abased	 selfabased
self-abasement	 selfabasement
self-abasing	 selfabasing
self-abnegating	 selfabnegating
self-abnegation	 selfabnegation
self-absorbed	 selfabsorbed
self-absorption	 selfabsorption
self-accusation	 selfaccusation
self-aggrandizement	 selfaggrandizement
self-aggrandizing	 selfaggrandizing
self-appointed	 selfappointed
self-asserting	 selfasserting
self-assertion	 selfassertion
self-assertive	 selfassertive
self-assertiveness	 selfassertiveness
self-assurance	 selfassurance
self-assured	 selfassured
self-assuring	 selfassuring
self-aware	 selfaware
self-awareness	 selfawareness
self-balancing	 selfbalancing
self-blame	 selfblame
self-care	 selfcare
self-centered	 selfcentered
self-centeredness	 selfcenteredness
self-collected	 selfcollected
self-command	 selfcommand
self-complacency	 selfcomplacency
self-complacent	 selfcomplacent
self-composed	 selfcomposed
self-composure	 selfcomposure
self-conceit	 selfconceit
self-conceited	 selfconceited
self-concern	 selfconcern
self-condemnation	 selfcondemnation
self-condemned	 selfcondemned
self-confessed	 selfconfessed
self-confidence	 selfconfidence
self-confident	 selfconfident
self-congratulating	 selfcongratulating
self-congratulation	 selfcongratulation
self-congratulatory	 selfcongratulatory
self-conscious	 selfconscious
self-consciously	 selfconsciously
self-consciousness	 selfconsciousness
self-consistent	 selfconsistent
self-contained	 selfcontained
self-contemplation	 selfcontemplation
self-control	 selfcontrol
self-controlled	 selfcontrolled
self-controlling	 selfcontrolling
self-critical	 selfcritical
self-criticism	 selfcriticism
self-cultivation	 selfcultivation
self-deceit	 selfdeceit
self-deceived	 selfdeceived
self-deceiving	 selfdeceiving
self-deception	 selfdeception
self-defeating	 selfdefeating
self-defence	 selfdefence
self-defense	 selfdefense
self-denial	 selfdenial
self-denied	 selfdenied
self-denier	 selfdenier
self-deniying	 selfdeniying
self-deprecating	 selfdeprecating
self-deprecation	 selfdeprecation
self-deprecatory	 selfdeprecatory
self-destruction	 selfdestruction
self-destructive	 selfdestructive
self-determination	 selfdetermination
self-determined	 selfdetermined
self-determining	 selfdetermining
self-discipline	 selfdiscipline
self-disciplined	 selfdisciplined
self-discovery	 selfdiscovery
self-disgust	 selfdisgust
self-disgusted	 selfdisgusted
self-distrust	 selfdistrust
self-doubt	 selfdoubt
self-doubting	 selfdoubting
self-educated	 selfeducated
self-education	 selfeducation
self-effaced	 selfeffaced
self-effacement	 selfeffacement
self-effacing	 selfeffacing
self-esteem	 selfesteem
self-evident	 selfevident
self-examination	 selfexamination
self-examining	 selfexamining
self-expression	 selfexpression
self-flagellated	 selfflagellated
self-flagellating	 selfflagellating
self-flagellation	 selfflagellation
self-forgetful	 selfforgetful
self-forgetfulness	 selfforgetfulness
self-forgetting	 selfforgetting
self-fulfillment	 selffulfillment
self-gratification	 selfgratification
self-hate	 selfhate
self-hating	 selfhating
self-hatred	 selfhatred
self-help	 selfhelp
self-importance	 selfimportance
self-important	 selfimportant
self-imposed	 selfimposed
self-improvement	 selfimprovement
self-indulged	 selfindulged
self-indulgence	 selfindulgence
self-indulgent	 selfindulgent
self-indulging	 selfindulging
self-interest	 selfinterest
self-interested	 selfinterested
self-involved	 selfinvolved
self-involvement	 selfinvolvement
self-justification	 selfjustification
self-justified	 selfjustified
self-justifying	 selfjustifying
self-knowledge	 selfknowledge
self-loathing	 selfloathing
self-love	 selflove
self-loving	 selfloving
self-made	 selfmade
self-mortification	 selfmortification
self-motivated	 selfmotivated
self-motivation	 selfmotivation
self-neglect	 selfneglect
self-obsessed	 selfobsessed
self-obsession	 selfobsession
self-opinion	 selfopinion
self-opinionated	 selfopinionated
self-pity	 selfpity
self-pitying	 selfpitying
self-possessed	 selfpossessed
self-possession	 selfpossession
self-praise	 selfpraise
self-preservation	 selfpreservation
self-preserving	 selfpreserving
self-pride	 selfpride
self-protection	 selfprotection
self-punishment	 selfpunishment
self-realization	 selfrealization
self-reliance	 selfreliance
self-reliant	 selfreliant
self-relying	 selfrelying
self-renewal	 selfrenewal
self-renewing	 selfrenewing
self-reproach	 selfreproach
self-reproached	 selfreproached
self-reproachful	 selfreproachful
self-reproaching	 selfreproaching
self-respect	 selfrespect
self-respectful	 selfrespectful
self-respecting	 selfrespecting
self-restrained	 selfrestrained
self-restraining	 selfrestraining
self-restraint	 selfrestraint
self-righteous	 selfrighteous
self-righteousness	 selfrighteousness
self-sacrifice	 selfsacrifice
self-sacrificing	 selfsacrificing
self-satisfaction	 selfsatisfaction
self-satisfied	 selfsatisfied
self-satisfying	 selfsatisfying
self-seeking	 selfseeking
self-sufficiency	 selfsufficiency
self-sufficient	 selfsufficient
self-torment	 selftorment
self-tormented	 selftormented
self-torture	 selftorture
self-tortured	 selftortured
self-will	 selfwill
self-willed	 selfwilled
self-worship	 selfworship
self-worth	 selfworth
semi darkness	 semidarkness
semi-darkness	 semidarkness
sergeant major	 sergeantmajor
sergeant-major	 sergeantmajor
sharp edged	 sharpedged
sharp-edged	 sharpedged
short lived	 shortlived
short sighted	 shortsighted
short tempered	 shorttempered
short term	 shortterm
short-lived	 shortlived
short-sighted	 shortsighted
short-tempered	 shorttempered
short-term	 shortterm
simple minded	 simpleminded
simple-minded	 simpleminded
single minded	 singleminded
single mindedness	 singlemindedness
single-minded	 singleminded
single-mindedness	 singlemindedness
sister in law	 sisterinlaw
sister-in-law	 sisterinlaw
sitting room	 sittingroom
sitting-room	 sittingroom
sky blue	 skyblue
sky-blue	 skyblue
slow motion	 slowmotion
slow moving	 slowmoving
slow-motion	 slowmotion
slow-moving	 slowmoving
smart alecky	 smartalecky
smart-alecky	 smartalecky
snow white	 snowwhite
snow-white	 snowwhite
soft hearted	 softhearted
soft heartedness	 softheartedness
soft spoken	 softspoken
soft-hearted	 softhearted
soft-heartedness	 softheartedness
soft-spoken	 softspoken
son in law	 soninlaw
son-in-law	 soninlaw
south africa	 southafrica
south african	 southafrican
south carolina	 southcarolina
soviet union	 sovietunion
st. augustine	 staugustine
st.Â clare	 stclare
st. francis	 stfrancis
st. james	 stjames
st. john	 stjohn
st. louis	 stlouis
st. nicholas	 stnicholas
st. paul	 stpaul
st. peter	 stpeter
st. petersburg	 stpetersburg
stainless steel	 stainlesssteel
stainless-steel	 stainlesssteel
state run	 staterun
state-run	 staterun
station wagon	 stationwagon
steering wheel	 steeringwheel
stiff necked	 stiffnecked
stiff-necked	 stiffnecked
straight ahead	 straightahead
straight backed	 straightbacked
straight-backed	 straightbacked
strange looking	 strangelooking
strange-looking	 strangelooking
strong willed	 strongwilled
strong-willed	 strongwilled
summer house	 summerhouse
summer-house	 summerhouse
supreme court	 supremecourt
sweat soaked	 sweatsoaked
sweat-soaked	 sweatsoaked
sweet smelling	 sweetsmelling
sweet-smelling	 sweetsmelling
swimming pool	 swimmingpool
t shirt	 tshirt
t shirts	 tshirts
t-shirt	 tshirt
t-shirts	 tshirts
tape recorder	 taperecorder
taxi driver	 taxidriver
tea table	 teatable
tea-table	 teatable
tear stained	 tearstained
tear-stained	 tearstained
tell tale	 telltale
tell-tale	 telltale
thank god	 thankgod
thank you	 thankyou
thank-you	 thankyou
thick set	 thickset
thick-set	 thickset
thin skinned	 thinskinned
thin-skinned	 thinskinned
third class	 thirdclass
third-class	 thirdclass
tight fitting	 tightfitting
tight lipped	 tightlipped
tight-fitting	 tightfitting
tight-lipped	 tightlipped
to day	 today
to morrow	 tomorrow
to night	 tonight
to-day	 today
to-morrow	 tomorrow
to-night	 tonight
toilet paper	 toiletpaper
tongue tied	 tonguetied
tongue-tied	 tonguetied
topsy turvy	 topsyturvy
topsy-turvy	 topsyturvy
tough minded	 toughminded
tough-minded	 toughminded
trap door	 trapdoor
trap-door	 trapdoor
uncle sam	 unclesam
united nations	 unitednations
united states	 unitedstates
up stairs	 upstairs
up to date	 uptodate
up-stairs	 upstairs
up-to-date	 uptodate
upper class	 upperclass
upper-class	 upperclass
upside down	 upsidedown
vice president	 vicepresident
vice versa	 viceversa
vice-president	 vicepresident
virgin mary	 virginmary
waist high	 waisthigh
waist-high	 waisthigh
waiting room	 waitingroom
waiting-room	 waitingroom
walkie talkie	 walkietalkie
walkie-talkie	 walkietalkie
wall street	 wallstreet
warm hearted	 warmhearted
warm-hearted	 warmhearted
washington d.c.	 washingtondc
washington, d.c.	 washingtondc
weather beaten	 weatherbeaten
weather-beaten	 weatherbeaten
week end	 weekend
week-end	 weekend
well balanced	 wellbalanced
well behaved	 wellbehaved
well being	 wellbeing
well bred	 wellbred
well defined	 welldefined
well earned	 wellearned
well educated	 welleducated
well fed	 wellfed
well groomed	 wellgroomed
well informed	 wellinformed
well intentioned	 wellintentioned
well known	 wellknown
well mannered	 wellmannered
well meaning	 wellmeaning
well ordered	 wellordered
well shaped	 wellshaped
well trained	 welltrained
well worn	 wellworn
well-balanced	 wellbalanced
well-behaved	 wellbehaved
well-being	 wellbeing
well-bred	 wellbred
well-defined	 welldefined
well-earned	 wellearned
well-educated	 welleducated
well-fed	 wellfed
well-groomed	 wellgroomed
well-informed	 wellinformed
well-intentioned	 wellintentioned
well-known	 wellknown
well-mannered	 wellmannered
well-meaning	 wellmeaning
well-ordered	 wellordered
well-shaped	 wellshaped
well-trained	 welltrained
well-worn	 wellworn
white collar	 whitecollar
white faced	 whitefaced
white gloved	 whitegloved
white hot	 whitehot
white house	 whitehouse
white-collar	 whitecollar
white-faced	 whitefaced
white-gloved	 whitegloved
white-hot	 whitehot
wide awake	 wideawake
wide brimmed	 widebrimmed
wide eyed	 wideeyed
wide open	 wideopen
wide-awake	 wideawake
wide-brimmed	 widebrimmed
wide-eyed	 wideeyed
wide-open	 wideopen
wild eyed	 wildeyed
wild-eyed	 wildeyed
window sill	 windowsill
window-sill	 windowsill
working class	 workingclass
working-class	 workingclass
world war	 worldwar
world weariness	 worldweariness
world weary	 worldweary
world-weariness	 worldweariness
world-weary	 worldweary
worn out	 wornout
worn-out	 wornout
writing table	 writingtable
writing-table	 writingtable
x ray	 xray
x rays	 xrays
x-ray	 xray
x-rays	 xrays
